5	5	12
-22	17
75	40
0	8
8	10
10	12
1	2	3	1	2
2	2	2	1	2
1	2	3	1	2
1	1	1	1	1
1	2	3	1	2
0	0	0	0	0
0	0	0	0	0
0	0	0	0	0
0	0	0	0	0
0	0	0	0	0
2	6	18

