10	10	30
-42	28
60	50
0	19
19	26
26	31
1	1	5	5	3	3	5	5	2	2
1	1	3	2	3	3	1	3	2	2
1	1	3	2	3	3	1	3	2	2
5	1	4	2	2	2	1	4	2	5
3	3	3	2	3	3	1	3	3	3
3	3	3	2	3	3	1	3	3	3
5	1	4	1	1	1	1	4	2	5
2	2	1	2	2	2	2	1	2	2
3	3	1	3	3	3	3	1	3	3
1	1	5	5	3	3	5	5	2	2
0	0	5	5	0	0	5	5	0	0
0	0	0	0	0	0	0	0	0	0
0	0	0	0	0	0	0	0	0	0
5	0	4	0	0	0	0	4	0	5
0	0	0	0	0	0	0	0	0	0
0	0	0	0	0	0	0	0	0	0
5	0	4	0	0	0	0	4	0	5
0	0	0	0	0	0	0	0	0	0
0	0	0	0	0	0	0	0	0	0
0	0	5	5	0	0	5	5	0	0
4	33	44	55	66


				
