10	10	25
-42	28
60	45
0	14
14	20
20	26
1	1	2	1	3	3	1	2	1	1
2	2	2	1	2	2	1	2	2	2
3	3	3	1	3	3	1	3	3	3
5	5	5	4	3	3	4	5	5	5
5	5	5	2	2	2	2	5	5	5
5	5	5	2	2	2	2	5	5	5
5	5	5	4	3	3	4	5	5	5
1	1	1	1	1	1	1	1	1	1
2	2	2	1	2	2	1	2	2	2
1	1	2	1	3	3	1	2	1	1
0	0	0	0	0	0	0	0	0	0
0	0	0	0	0	0	0	0	0	0
0	0	0	0	0	0	0	0	0	0
5	5	5	4	0	0	4	5	5	5
5	5	5	0	0	0	0	5	5	5
5	5	5	0	0	0	0	5	5	5
5	5	5	4	0	0	4	5	5	5
0	0	0	0	0	0	0	0	0	0
0	0	0	0	0	0	0	0	0	0
0	0	0	0	0	0	0	0	0	0
8	12	17	23	26	73	76	82	87
