8	8	15
-36	26
65	40
0	11
11	14
14	16
1	3	2	1	2	3	1	2
3	3	2	1	2	3	1	3
2	2	2	1	2	3	2	2
1	1	1	1	2	1	1	1
2	2	2	2	2	2	2	2
3	3	3	1	2	3	3	3
1	1	2	1	2	3	1	1
2	3	2	1	2	3	1	2
0	0	0	0	0	0	0	0
0	0	0	0	0	0	0	0
0	0	0	0	0	0	0	0
0	0	0	0	0	0	0	0
0	0	0	0	0	0	0	0
0	0	0	0	0	0	0	0
0	0	0	0	0	0	0	0
0	0	0	0	0	0	0	0
8	0	9	18	27	36	45	54	63			
