10	10	20
-42	28
60	45
0	12
12	17
17	21
1	1	2	5	5	5	5	2	1	1
3	3	2	5	5	5	5	2	3	3
1	1	1	5	5	5	5	1	1	1
5	4	2	3	4	4	1	2	4	5
5	3	3	3	3	3	1	3	3	5
5	1	1	1	1	1	1	1	1	5
5	4	2	3	4	4	1	2	4	5
1	1	1	5	5	5	5	1	1	1
3	3	2	5	5	5	5	2	3	3
1	1	2	5	5	5	5	2	1	1
0	0	0	5	5	5	5	0	0	0
0	0	0	5	5	5	5	0	0	0
0	0	0	5	5	5	5	0	0	0
5	4	0	0	4	4	0	0	4	5
5	0	0	0	0	0	0	0	0	5
5	0	0	0	0	0	0	0	0	5
5	4	0	0	4	4	0	0	4	5
0	0	0	5	5	5	5	0	0	0
0	0	0	5	5	5	5	0	0	0
0	0	0	5	5	5	5	0	0	0
4	32	37	43	56


				
