9	9	40
-40	25
60	43
0	24
24	32
32	41
3	1	3	5	5	5	2	1	3
3	4	2	5	5	5	2	4	2
1	1	1	5	5	5	1	1	1
2	3	2	2	4	2	2	2	2
3	3	2	3	4	3	2	3	3
1	3	2	1	4	1	2	1	1
2	2	2	5	5	5	2	3	2
1	4	2	5	5	5	2	4	1
3	1	2	5	5	5	2	3	3
0	0	0	5	5	5	0	0	0
0	4	0	5	5	5	0	4	0
0	0	0	5	5	5	0	0	0
0	0	0	0	4	0	0	0	0
0	0	0	0	4	0	0	0	0
0	0	0	0	4	0	0	0	0
0	0	0	5	5	5	0	0	0
0	4	0	5	5	5	0	4	0
0	0	0	5	5	5	0	0	0
2	37	43

