7	7	20
-30	23
70	40
0	11
11	15
15	21
1	1	1	1	1	1	1
2	1	2	2	3	2	2
1	1	1	1	3	2	1
1	1	1	4	2	2	2
3	1	3	2	3	2	3
2	1	2	2	3	2	2
3	1	3	3	3	2	3
0	0	0	0	0	0	0
0	0	0	0	0	0	0
0	0	0	0	0	0	0
0	0	0	4	0	0	0
0	0	0	0	0	0	0
0	0	0	0	0	0	0
0	0	0	0	0	0	0
4	10	22	26	38
