7	7	12
-30	23
70	40
0	8
8	11
11	13
1	2	1	3	1	2	1
2	2	2	3	2	2	2
1	2	1	3	1	2	1
3	3	3	3	3	3	3
1	2	1	3	1	2	1
2	2	2	3	2	2	2
1	2	1	3	1	2	1
0	0	0	0	0	0	0
0	0	0	0	0	0	0
0	0	0	0	0	0	0
0	0	0	0	0	0	0
0	0	0	0	0	0	0
0	0	0	0	0	0	0
0	0	0	0	0	0	0
5	8	12	36	40	24			
