6	6	10
-28	15
70	35
0	4
4	7
7	11	
5	5	1	3	5	5
5	5	2	2	5	5
1	2	1	3	2	1
3	2	3	3	2	3
5	5	2	2	5	5
5	5	1	3	5	5
5	5	0	0	5	5
5	5	0	0	5	5
0	0	0	0	0	0
0	0	0	0	0	0
5	5	0	0	5	5
5	5	0	0	5	5
2	14	21

