7	7	18
-30	23
70	40
0	14
14	17
17	19
5	5	1	1	2	5	5
5	5	1	3	3	5	5
1	1	1	1	2	2	1
2	2	1	4	2	2	2
3	3	1	3	3	2	3
5	5	1	1	1	5	5
5	5	1	3	2	5	5
5	5	0	0	0	5	5
5	5	0	0	0	5	5
0	0	0	0	0	0	0
0	0	0	4	0	0	0
0	0	0	0	0	0	0
5	5	0	0	0	5	5
5	5	0	0	0	5	5
4	17	23	25	31
