5	5	20
-23	17
75	40
75	40
13	17
17	21
4	2	1	2	4
2	4	1	4	2
1	1	1	1	1
3	4	1	4	3
4	3	1	3	4
4	0	0	0	4
0	4	0	4	0
0	0	0	0	0
0	4	0	4	0
4	0	0	0	4
1	12

